1111111
1P0C0E1
1110111
1C00001 1
1111111
