NO ./textures/north.xpm
SO ./textures/south.xpm
WE ./textures/west.xpm
EA ./textures/east.xpm
F 220,100,0
C 225,30,0

111111111111111111111111111
100000000011000000000000001
101100000111000000000000001
100100000000000000000000001
111111101100000111000000001
100000001100000111011111111
111101111111110111000000001
111101111111110111010100001
110000001101010111000000001
100000000000000011000000001
100000000000000011010100001
110000011101010111110111N01
111101111111010110111101001
111111111111111111111111111
