111111111
1P0000C01
101110101
100010001
1C01110E1
111111111
