1111111111111111
1P0000000C000001
1111011110111101
1C000000000000E1
1011110111111101
1C0000C0000000C1
1111111111111111

