111111111111
1P0000010001
1011111011101
100000001C001
1110111111011
1C00100000E1
111111111111
