111111
1P01C1
1E0101
1C0001
111111
